29,29,29,29,29,29,29,29,29,29,29,29,29,29,29,29,29,29,29,29,29,29,29,29,29,29,29,29,29,29,29,29,29,29,29,29,29,29,29,29,29,29,29,29,29,29,29,29,29,29,29,29,29,29,29,29,29,29,29
29,29,29,29,29,29,29,29,29,29,29,29,29,29,29,29,29,29,29,29,29,29,29,29,29,29,29,29,29,29,29,29,29,29,29,29,29,29,29,29,29,29,29,29,29,29,29,29,29,29,29,29,29,29,29,29,29,29,29
29,29,29,29,29,29,29,29,29,29,29,29,29,29,29,29,29,29,29,29,29,29,29,29,29,29,29,29,29,29,29,29,29,29,29,29,29,29,29,29,29,29,29,29,29,29,29,29,29,29,29,29,29,29,29,29,29,29,29
29,29,29,29,29,29,29,29,29,29,29,29,29,29,29,29,29,29,29,29,29,29,29,29,29,29,29,29,29,29,29,29,29,29,29,29,29,29,29,29,29,29,29,29,29,29,29,29,29,29,29,29,29,29,29,29,29,29,29
29,29,29,29,29,29,29,29,29,29,29,29,29,29,29,29,29,29,29,29,29,29,29,29,29,29,29,29,29,29,29,29,29,29,29,29,29,29,29,29,29,29,29,29,29,29,29,29,29,29,29,29,29,29,29,29,29,29,29
29,29,29,29,29,29,29,29,29,29,29,29,29,29,29,29,29,29,29,29,29,29,29,29,29,29,29,29,29,29,29,29,29,29,29,29,29,29,29,29,29,29,29,29,29,29,29,29,29,29,29,29,29,29,29,29,29,29,29
29,29,29,29,29,29,29,29,29,29,29,29,29,29,29,29,29,29,29,29,29,29,29,29,29,29,29,29,29,29,29,29,29,29,29,29,29,29,29,29,29,29,29,29,29,29,29,29,29,29,29,29,29,29,29,29,29,29,29
29,29,29,29,29,29,29,29,29,29,29,29,29,29,29,29,29,29,29,29,29,29,29,29,29,29,29,29,29,29,29,29,29,29,29,29,29,29,29,29,29,29,29,29,29,29,29,29,29,29,29,29,29,29,29,29,29,29,29
29,29,29,29,29,29,29,29,29,29,29,29,29,29,29,29,29,29,29,29,29,29,29,29,29,29,29,29,29,29,29,29,29,29,29,29,29,29,29,29,29,29,29,29,29,29,29,29,29,29,29,29,29,29,29,29,29,29,29
29,29,29,29,29,29,29,29,29,29,29,29,29,29,29,29,29,29,29,29,29,29,29,29,29,29,29,29,29,29,29,29,29,29,29,29,29,29,29,29,29,29,29,29,29,29,29,29,29,29,29,29,29,29,29,29,29,29,29
29,29,29,29,29,29,29,29,29,29,358,358,358,358,358,358,358,358,358,358,358,358,358,358,358,358,358,358,358,358,358,358,358,358,358,358,358,358,358,358,358,358,358,358,358,358,358,358,358,29,29,29,29,29,29,29,29,29,29
29,29,29,29,29,29,29,29,29,29,358,358,358,358,358,358,358,358,358,358,358,358,358,358,358,358,358,358,358,358,358,358,358,358,358,358,358,358,358,358,358,358,358,358,358,358,358,358,358,29,29,29,29,29,29,29,29,29,29
29,29,29,29,29,29,29,29,29,29,358,358,358,358,358,358,358,358,358,358,358,358,358,358,358,358,358,358,358,358,358,358,358,358,358,358,358,358,358,358,358,358,358,358,358,358,358,358,358,29,29,29,29,29,29,29,29,29,29
29,29,29,29,29,29,29,29,29,29,358,358,358,96,97,98,99,100,101,102,103,104,105,106,107,108,109,110,358,358,358,96,97,98,99,100,101,102,103,104,105,106,107,108,109,110,358,358,358,29,29,29,29,29,29,29,29,29,29
29,29,29,29,29,29,29,29,29,29,358,358,358,119,120,121,122,123,124,125,126,127,128,129,130,131,132,133,358,358,358,119,120,121,122,123,124,125,126,127,128,129,130,131,132,133,358,358,358,29,29,29,29,29,29,29,29,29,29
29,29,29,29,29,29,29,29,29,29,358,358,358,142,143,144,145,146,147,148,149,150,151,152,153,154,155,156,358,358,358,142,143,144,145,146,147,148,149,150,151,152,153,154,155,156,358,358,358,29,29,29,29,29,29,29,29,29,29
29,29,29,29,29,29,29,29,29,29,358,358,358,165,166,167,168,169,170,171,172,173,174,175,176,177,178,179,358,358,358,165,166,167,168,169,170,171,172,173,174,175,176,177,178,179,358,358,358,29,29,29,29,29,29,29,29,29,29
29,29,29,29,29,29,29,29,29,29,358,358,358,188,189,190,191,192,193,194,195,196,197,198,199,200,201,202,358,358,358,188,189,190,191,192,193,194,195,196,197,198,199,200,201,202,358,358,358,29,29,29,29,29,29,29,29,29,29
29,29,29,29,29,29,29,29,29,29,358,358,358,211,212,213,214,215,216,217,218,219,220,221,222,223,224,225,358,358,358,211,212,213,214,215,216,217,218,219,220,221,222,223,224,225,358,358,358,29,29,29,29,29,29,29,29,29,29
29,29,29,29,29,29,29,29,29,29,358,358,358,234,235,236,237,238,239,240,241,242,243,244,245,246,247,248,358,358,358,234,235,236,237,238,239,240,241,242,243,244,245,246,247,248,358,358,358,29,29,29,29,29,29,29,29,29,29
29,29,29,29,29,29,29,29,29,29,358,358,358,257,258,259,260,261,262,263,264,265,266,267,268,269,270,271,358,358,358,257,258,259,260,261,262,263,264,265,266,267,268,269,270,271,358,358,358,29,29,29,29,29,29,29,29,29,29
29,29,29,29,29,29,29,29,29,29,358,358,358,280,281,282,283,284,285,286,287,288,289,290,291,292,293,294,358,358,358,280,281,282,283,284,285,286,287,288,289,290,291,292,293,294,358,358,358,29,29,29,29,29,29,29,29,29,29
29,29,29,29,29,29,29,29,29,29,358,358,358,303,304,305,306,307,308,309,310,311,312,313,314,315,316,317,358,358,358,303,304,305,306,307,308,309,310,311,312,313,314,315,316,317,358,358,358,29,29,29,29,29,29,29,29,29,29
29,29,29,29,29,29,29,29,29,29,358,358,358,326,327,328,329,330,331,332,333,334,335,336,337,338,339,340,358,358,358,326,327,328,329,330,331,332,333,334,335,336,337,338,339,340,358,358,358,29,29,29,29,29,29,29,29,29,29
29,29,29,29,29,29,29,29,29,29,358,358,358,358,358,358,358,358,358,358,358,358,358,358,358,358,358,358,358,358,358,358,358,358,358,358,358,358,358,358,358,358,358,358,358,358,358,358,358,29,29,29,29,29,29,29,29,29,29
29,29,29,29,29,29,29,29,29,29,358,358,358,358,358,358,358,358,358,358,358,358,358,358,358,358,358,358,358,358,358,358,358,358,358,358,358,358,358,358,358,358,358,358,358,358,358,358,358,29,29,29,29,29,29,29,29,29,29
29,29,29,29,29,29,29,29,29,29,358,358,358,358,358,358,358,358,358,358,358,358,358,358,358,358,358,358,358,358,358,358,358,358,358,358,358,358,358,358,358,358,358,358,358,358,358,358,358,29,29,29,29,29,29,29,29,29,29
29,29,29,29,29,29,29,29,29,29,358,358,358,96,97,98,99,100,101,102,103,104,105,106,107,108,109,110,358,358,358,96,97,98,99,100,101,102,103,104,105,106,107,108,109,110,358,358,358,29,29,29,29,29,29,29,29,29,29
29,29,29,29,29,29,29,29,29,29,358,358,358,119,120,121,122,123,124,125,126,127,128,129,130,131,132,133,358,358,358,119,120,121,122,123,124,125,126,127,128,129,130,131,132,133,358,358,358,29,29,29,29,29,29,29,29,29,29
29,29,29,29,29,29,29,29,29,29,358,358,358,142,143,144,145,146,147,148,149,150,151,152,153,154,155,156,358,358,358,142,143,144,145,146,147,148,149,150,151,152,153,154,155,156,358,358,358,29,29,29,29,29,29,29,29,29,29
29,29,29,29,29,29,29,29,29,29,358,358,358,165,166,167,168,169,170,171,172,173,174,175,176,177,178,179,358,358,358,165,166,167,168,169,170,171,172,173,174,175,176,177,178,179,358,358,358,29,29,29,29,29,29,29,29,29,29
29,29,29,29,29,29,29,29,29,29,358,358,358,188,189,190,191,192,193,194,195,196,197,198,199,200,201,202,358,358,358,188,189,190,191,192,193,194,195,196,197,198,199,200,201,202,358,358,358,29,29,29,29,29,29,29,29,29,29
29,29,29,29,29,29,29,29,29,29,358,358,358,211,212,213,214,215,216,217,218,219,220,221,222,223,224,225,358,358,358,211,212,213,214,215,216,217,218,219,220,221,222,223,224,225,358,358,358,29,29,29,29,29,29,29,29,29,29
29,29,29,29,29,29,29,29,29,29,358,358,358,234,235,236,237,238,239,240,241,242,243,244,245,246,247,248,358,358,358,234,235,236,237,238,239,240,241,242,243,244,245,246,247,248,358,358,358,29,29,29,29,29,29,29,29,29,29
29,29,29,29,29,29,29,29,29,29,358,358,358,257,258,259,260,261,262,263,264,265,266,267,268,269,270,271,358,358,358,257,258,259,260,261,262,263,264,265,266,267,268,269,270,271,358,358,358,29,29,29,29,29,29,29,29,29,29
29,29,29,29,29,29,29,29,29,29,358,358,358,280,281,282,283,284,285,286,287,288,289,290,291,292,293,294,358,358,358,280,281,282,283,284,285,286,287,288,289,290,291,292,293,294,358,358,358,29,29,29,29,29,29,29,29,29,29
29,29,29,29,29,29,29,29,29,29,358,358,358,303,304,305,306,307,308,309,310,311,312,313,314,315,316,317,358,358,358,303,304,305,306,307,308,309,310,311,312,313,314,315,316,317,358,358,358,29,29,29,29,29,29,29,29,29,29
29,29,29,29,29,29,29,29,29,29,358,358,358,326,327,328,329,330,331,332,333,334,335,336,337,338,339,340,358,358,358,326,327,328,329,330,331,332,333,334,335,336,337,338,339,340,358,358,358,29,29,29,29,29,29,29,29,29,29
29,29,29,29,29,29,29,29,29,29,358,358,358,358,358,358,358,358,358,358,358,358,358,358,358,358,358,358,358,358,358,358,358,358,358,358,358,358,358,358,358,358,358,358,358,358,358,358,358,29,29,29,29,29,29,29,29,29,29
29,29,29,29,29,29,29,29,29,29,358,358,358,358,358,358,358,358,358,358,358,358,358,358,358,358,358,358,358,358,358,358,358,358,358,358,358,358,358,358,358,358,358,358,358,358,358,358,358,29,29,29,29,29,29,29,29,29,29
29,29,29,29,29,29,29,29,29,29,358,358,358,358,358,358,358,358,358,358,358,358,358,358,358,358,358,358,358,358,358,358,358,358,358,358,358,358,358,358,358,358,358,358,358,358,358,358,358,29,29,29,29,29,29,29,29,29,29
29,29,29,29,29,29,29,29,29,29,29,29,29,29,29,29,29,29,29,29,29,29,29,29,29,29,29,29,29,29,29,29,29,29,29,29,29,29,29,29,29,29,29,29,29,29,29,29,29,29,29,29,29,29,29,29,29,29,29
29,29,29,29,29,29,29,29,29,29,29,29,29,29,29,29,29,29,29,29,29,29,29,29,29,29,29,29,29,29,29,29,29,29,29,29,29,29,29,29,29,29,29,29,29,29,29,29,29,29,29,29,29,29,29,29,29,29,29
29,29,29,29,29,29,29,29,29,29,29,29,29,29,29,29,29,29,29,29,29,29,29,29,29,29,29,29,29,29,29,29,29,29,29,29,29,29,29,29,29,29,29,29,29,29,29,29,29,29,29,29,29,29,29,29,29,29,29
29,29,29,29,29,29,29,29,29,29,29,29,29,29,29,29,29,29,29,29,29,29,29,29,29,29,29,29,29,29,29,29,29,29,29,29,29,29,29,29,29,29,29,29,29,29,29,29,29,29,29,29,29,29,29,29,29,29,29
29,29,29,29,29,29,29,29,29,29,29,29,29,29,29,29,29,29,29,29,29,29,29,29,29,29,29,29,29,29,29,29,29,29,29,29,29,29,29,29,29,29,29,29,29,29,29,29,29,29,29,29,29,29,29,29,29,29,29
29,29,29,29,29,29,29,29,29,29,29,29,29,29,29,29,29,29,29,29,29,29,29,29,29,29,29,29,29,29,29,29,29,29,29,29,29,29,29,29,29,29,29,29,29,29,29,29,29,29,29,29,29,29,29,29,29,29,29
29,29,29,29,29,29,29,29,29,29,29,29,29,29,29,29,29,29,29,29,29,29,29,29,29,29,29,29,29,29,29,29,29,29,29,29,29,29,29,29,29,29,29,29,29,29,29,29,29,29,29,29,29,29,29,29,29,29,29
29,29,29,29,29,29,29,29,29,29,29,29,29,29,29,29,29,29,29,29,29,29,29,29,29,29,29,29,29,29,29,29,29,29,29,29,29,29,29,29,29,29,29,29,29,29,29,29,29,29,29,29,29,29,29,29,29,29,29
29,29,29,29,29,29,29,29,29,29,29,29,29,29,29,29,29,29,29,29,29,29,29,29,29,29,29,29,29,29,29,29,29,29,29,29,29,29,29,29,29,29,29,29,29,29,29,29,29,29,29,29,29,29,29,29,29,29,29
29,29,29,29,29,29,29,29,29,29,29,29,29,29,29,29,29,29,29,29,29,29,29,29,29,29,29,29,29,29,29,29,29,29,29,29,29,29,29,29,29,29,29,29,29,29,29,29,29,29,29,29,29,29,29,29,29,29,29
